11111111111111111111111111111111
10000000000000000001000000000001
10111101011111111101011110111101
10000001000000000001000000000001
10111101011111101101011111111101
10000001000000101101000000000001
11101111011110100000010101010101
10000000000110111101110101000101
10111001110110000000000101101101
10110011100010111110110101100111
10110110101010111110110101110111
10110000001000000000000101100001
10110111111101110111110100001011
10110011111101110111100111011111
10000000000100000000000000000001
10111111110001111111101111110101
10000000000100010000001111110101
10111101110101010101100000110001
10000000000101000100001110000101
11111111111111111111111111111111
